33333333333333333333333333333333
30000000000000000000010000000003
3000003000000000003000000003003
30000030000000003333000003000003
30000030000000000003000000000003
30000030000000000000000003000033
30000000000000000003000003000003
30000000000000000003000003000003
30000000003000033333000000000003
33000033333000022200000000000003
33000000000000000000030000000003
03000000000000330003003003000033
33333000000033300000000000000003
30000000000000000003000003300003
30033000033330000000000003000030
30000000000030000000333333000030
30330000000000000000000000000030
30000000000000000000000000000030
30003333000003333330000000300030
30300000000000000000000000000030
00000000333300000000000033000030
30000000300300000333330000000030
00003000300030000000000000303033
00000000000030000000000000000000
30000000000000300000003000000000
30000000030000000333003030000000
30000000000000000000000000000000
30333003000000033300000000300000
00000000000000000000003330000000
00000000000000000000000000003003
33333333333333333333333333333333
